Month,Mug Sales,Mud Pot Sales,Saree Sales,Wooden Spoon Sales,Ceramic Plate Sales,Handmade Basket Sales,Leather Bag Sales,Knitted Scarf Sales,Glass Art Sales,Handcrafted Candle Sales
2024-12,290,110,320,125,140,105,95,50,70,150,85
2024-11,280,115,310,120,130,100,90,55,65,145,80
2024-10,270,120,300,115,135,95,85,60,75,140,105
2024-09,260,125,290,130,125,110,80,65,60,135,100
2024-08,250,130,280,135,150,115,75,70,85,130,95
2024-07,240,105,270,140,160,120,70,75,90,125,80
2024-06,230,110,260,95,150,125,85,50,55,120,100
2024-05,220,100,250,90,140,130,80,45,60,115,105
2024-04,210,105,240,85,130,135,75,40,70,110,110
2024-03,200,95,230,80,120,140,70,35,65,105,115
2024-02,190,90,220,75,110,145,65,30,60,100,120
2024-01,180,85,210,70,100,150,60,25,55,95,125
2023-12,170,80,200,65,105,160,55,20,50,90,130
2023-11,160,75,190,60,115,155,50,15,45,85,135
2023-10,150,70,180,55,120,150,45,10,40,80,140
2023-09,290,65,170,50,125,145,40,35,55,75,135
2023-08,280,60,160,45,130,140,35,40,50,70,130
2023-07,270,55,150,40,135,135,30,45,65,65,125
2023-06,260,50,140,35,140,130,25,50,60,60,120
2023-05,250,45,130,30,145,125,20,55,75,55,115
2023-04,240,40,120,25,150,120,15,60,70,50,110
2023-03,230,35,110,20,155,115,10,65,65,45,105
2023-02,220,30,100,15,160,110,20,70,60,40,100
2023-01,210,25,90,10,165,105,25,75,55,35,95
2022-12,200,20,80,5,170,95,30,80,50,30,90
2022-11,190,15,85,10,160,100,25,65,45,40,85
2022-10,180,10,75,15,150,105,20,70,40,50,80
2022-09,170,5,70,20,140,110,35,75,35,60,75
2022-08,160,10,65,25,130,115,30,80,30,55,70
2022-07,150,15,60,30,120,120,25,85,25,50,65
2022-06,140,20,55,35,110,125,20,90,20,45,60
2022-05,130,25,50,40,100,130,15,95,15,40,55
2022-04,120,30,45,45,90,135,10,60,60,35,50
2022-03,110,35,40,50,85,140,35,65,55,30,45
2022-02,100,40,35,55,80,145,30,50,50,25,40
2022-01,90,45,30,60,75,150,25,45,45,20,35
2021-12,260,135,310,105,210,125,145,62,52,115
2021-11,250,130,300,100,200,120,140,60,50,110
2021-10,240,125,290,95,190,115,135,58,48,105
2021-09,230,120,280,90,180,110,130,56,46,100
2021-08,220,115,270,85,170,105,125,54,44,95
2021-07,210,110,260,80,160,100,120,52,42,90
2021-06,200,105,250,75,150,95,115,50,40,85
2021-05,190,100,240,70,140,90,110,48,38,80
2021-04,180,95,230,65,130,85,105,46,36,75
2021-03,170,90,220,60,120,80,100,44,34,70
2021-02,160,85,210,55,110,75,95,42,32,65
2021-01,150,80,200,50,100,70,90,40,30,60
2020-12,140,75,190,45,90,65,85,35,25,55,50
2020-11,130,70,180,40,100,60,80,30,20,50,45
2020-10,120,65,170,35,110,55,75,25,15,45,40
2020-09,110,60,160,30,120,50,70,20,10,40,35
2020-08,100,55,150,25,130,45,65,15,5,35,30
2020-07,90,50,140,20,140,40,60,10,25,30,25
2020-06,80,45,130,15,150,35,55,5,20,25,20
2020-05,70,40,120,10,160,30,50,30,15,20,15
2020-04,60,35,110,5,170,25,45,25,10,15,10
2020-03,50,30,100,20,180,20,40,20,5,10,5
2020-02,40,25,90,15,190,15,35,15,10,5,40
2020-01,30,20,80,10,200,10,30,10,15,5,35
2020-12,140,75,190,45,90,65,85,35,25,55,50
2020-11,130,70,180,40,100,60,80,30,20,50,45
2020-10,120,65,170,35,110,55,75,25,15,45,40
2020-09,110,60,160,30,120,50,70,20,10,40,35
2020-08,100,55,150,25,130,45,65,15,5,35,30
2020-07,90,50,140,20,140,40,60,10,25,30,25
2020-06,80,45,130,15,150,35,55,5,20,25,20
2020-05,70,40,120,10,160,30,50,30,15,20,15
2020-04,60,35,110,5,170,25,45,25,10,15,10
2020-03,50,30,100,20,180,20,40,20,5,10,5
2020-02,40,25,90,15,190,15,35,15,10,5,40
2020-01,30,20,80,10,200,10,30,10,15,5,35
2019-12,140,70,190,15,180,60,40,5,10,30,20
2019-11,130,65,180,10,170,55,35,15,5,25,25
2019-10,120,60,170,5,160,50,30,10,15,20,30
2019-09,110,55,160,20,150,45,25,5,20,10,35
2019-08,100,50,150,15,140,40,20,10,30,15,40
2019-07,90,45,140,10,130,35,15,20,25,5,45
2019-06,80,40,130,5,120,30,10,25,20,10,50
2019-05,70,35,120,15,110,25,20,30,15,5,55
2019-04,60,30,110,20,100,20,25,35,10,15,60
2019-03,50,25,100,25,90,15,30,40,5,10,65
2019-02,40,20,90,30,80,10,35,45,15,5,70
2019-01,30,15,80,35,70,5,40,50,10,20,75
2018-12,140,35,190,10,180,40,20,15,50,30,5
2018-11,130,30,180,5,170,35,15,10,45,25,10
2018-10,120,25,170,20,160,30,10,35,40,5,15
2018-09,110,20,160,15,150,25,5,30,35,10,20
2018-08,100,15,150,10,140,20,30,25,50,15,25
2018-07,90,10,140,5,130,15,25,20,45,20,30
2018-06,80,5,130,50,120,10,20,15,40,25,35
2018-05,70,30,120,45,110,5,15,10,35,30,40
2018-04,60,25,110,40,100,50,10,5,30,35,45
2018-03,50,20,100,35,90,45,5,10,25,40,50
2018-02,40,15,90,30,80,40,10,15,20,45,55
2018-01,30,10,80,25,70,35,15,20,15,50,60
2017-12,140,5,190,20,180,10,50,15,60,30,25
2017-11,130,10,180,15,170,5,55,20,65,25,30
2017-10,120,15,170,10,160,50,60,25,70,20,35
2017-09,110,20,160,5,150,55,65,30,75,15,40
2017-08,100,25,150,50,140,60,70,35,80,10,45
2017-07,90,30,140,45,130,65,75,40,85,5,50
2017-06,80,35,130,40,120,70,80,45,90,50,55
2017-05,70,40,120,35,110,75,85,50,95,45,60
2017-04,60,45,110,30,100,80,90,55,100,40,65
2017-03,50,50,100,25,90,85,95,60,105,35,70
2017-02,40,55,90,20,80,90,100,65,110,30,75
2017-01,30,60,80,15,70,95,105,70,115,25,80
2016-12,140,65,190,10,180,60,40,5,10,50,35
2016-11,130,60,180,5,170,55,35,10,45,15,40
2016-10,120,55,170,50,160,50,30,5,40,10,45
2016-09,110,50,160,45,150,45,25,10,35,5,50
2016-08,100,45,150,40,140,40,20,15,30,50,55
2016-07,90,40,140,35,130,35,15,20,25,45,60
2016-06,80,35,130,30,120,30,10,25,20,40,65
2016-05,70,30,120,25,110,25,50,30,15,35,70
2016-04,60,25,110,20,100,20,45,35,10,30,75
2016-03,50,20,100,15,90,15,40,40,5,25,80
2016-02,40,15,90,10,80,10,35,45,50,20,85
2016-01,30,10,80,5,70,5,30,50,45,15,90
2015-12,140,5,190,60,180,70,80,65,85,10,20
2015-11,130,10,180,55,170,75,85,60,90,5,25
2015-10,120,15,170,50,160,80,90,55,95,10,30
2015-09,110,20,160,45,150,85,95,50,100,15,35
2015-08,100,25,150,40,140,90,100,45,105,20,40
2015-07,90,30,140,35,130,95,105,40,110,25,45
2015-06,80,35,130,30,120,100,110,35,115,30,50
2015-05,70,40,120,25,110,105,115,30,120,35,55
2015-04,60,45,110,20,100,110,120,25,125,40,60
2015-03,50,50,100,15,90,115,125,20,130,45,65
2015-02,40,55,90,10,80,120,130,15,135,50,70
2015-01,30,60,80,5,70,125,135,10,140,55,75
2014-12,140,65,190,50,180,110,85,105,10,5,125
2014-11,130,60,180,45,170,105,80,100,15,10,130
2014-10,120,55,170,40,160,100,75,95,20,15,135
2014-09,110,50,160,35,150,95,70,90,25,20,140
2014-08,100,45,150,30,140,90,65,85,30,25,145
2014-07,90,40,140,25,130,85,60,80,35,30,150
2014-06,80,35,130,20,120,80,55,75,40,35,155
2014-05,70,30,120,15,110,75,50,70,45,40,160
2014-04,60,25,110,10,100,70,45,65,50,45,165
2014-03,50,20,100,5,90,65,40,60,55,50,170
2014-02,40,15,90,10,80,60,35,55,60,55,175
2014-01,30,10,80,15,70,55,30,50,65,60,180
2013-12,140,60,190,5,180,50,125,70,55,10,65
2013-11,130,55,180,10,170,45,120,65,50,15,70
2013-10,120,50,170,15,160,40,115,60,45,20,75
2013-09,110,45,160,20,150,35,110,55,40,25,80
2013-08,100,40,150,25,140,30,105,50,35,30,85
2013-07,90,35,140,30,130,25,100,45,30,35,90
2013-06,80,30,130,35,120,20,95,40,25,40,95
2013-05,70,25,120,40,110,15,90,35,20,45,100
2013-04,60,20,110,45,100,10,85,30,15,50,105
2013-03,50,15,100,50,90,5,80,25,10,55,110
2013-02,40,10,90,55,80,60,75,20,5,60,115
2013-01,30,5,80,60,70,65,70,15,10,65,120
2012-12,140,105,190,50,180,60,80,125,5,70,10
2012-11,130,100,180,45,170,55,75,120,10,65,15
2012-10,120,95,170,40,160,50,70,115,15,60,20
2012-09,110,90,160,35,150,45,65,110,20,55,25
2012-08,100,85,150,30,140,40,60,105,25,50,30
2012-07,90,80,140,25,130,35,55,100,30,45,35
2012-06,80,75,130,20,120,30,50,95,35,40,40
2012-05,70,70,120,15,110,25,45,90,40,35,45
2012-04,60,65,110,10,100,20,40,85,45,30,50
2012-03,50,60,100,5,90,15,35,80,50,25,55
2012-02,40,55,90,10,80,10,30,75,55,20,60
2012-01,30,50,80,15,70,5,25,70,60,15,65
2011-12,140,90,190,60,180,30,10,105,50,70,125
2011-11,130,85,180,55,170,25,20,100,45,65,120
2011-10,120,80,170,50,160,20,30,95,40,60,115
2011-09,110,75,160,45,150,15,40,90,35,55,110
2011-08,100,70,150,40,140,10,50,85,30,50,105
2011-07,90,65,140,35,130,5,60,80,25,45,100
2011-06,80,60,130,30,120,55,70,75,20,40,95
2011-05,70,55,120,25,110,50,80,70,15,35,90
2011-04,60,50,110,20,100,45,90,65,10,30,85
2011-03,50,45,100,15,90,40,100,60,5,25,80
2011-02,40,40,90,10,80,35,110,55,50,20,75
2011-01,30,35,80,5,70,30,120,50,60,15,70
2010-12,140,25,190,20,180,90,35,105,10,125,60
2010-11,130,20,180,15,170,85,40,100,5,120,65
2010-10,120,15,170,10,160,80,45,95,55,115,70
2010-09,110,10,160,5,150,75,50,90,60,110,75
2010-08,100,5,150,60,140,70,55,85,65,105,80
2010-07,90,60,140,55,130,65,60,80,70,100,85
2010-06,80,55,130,50,120,60,65,75,75,95,90
2010-05,70,50,120,45,110,55,70,70,80,90,95
2010-04,60,45,110,40,100,50,75,65,85,85,100
2010-03,50,40,100,35,90,45,80,60,90,80,105
2010-02,40,35,90,30,80,40,85,55,95,75,110
2010-01,30,30,80,25,70,35,90,50,100,70,115
2009-12,180,250,90,320,145,210,50,290,75,130,170
2009-11,165,230,85,310,130,220,55,275,70,140,190
2009-10,150,240,95,300,120,200,60,280,65,150,160
2009-09,190,210,80,290,100,215,45,265,85,160,135
2009-08,175,205,120,275,110,195,40,250,90,125,145
2009-07,160,245,85,260,135,185,55,240,100,115,155
2009-06,205,225,70,245,125,175,50,230,95,140,180
2009-05,170,210,95,235,105,160,60,215,85,150,170
2009-04,155,200,100,220,140,155,45,200,90,130,165
2009-03,185,190,75,210,115,145,55,195,80,120,130
2009-02,140,185,65,205,90,170,50,180,70,125,150
2009-01,130,175,80,190,100,160,60,170,75,135,140
2008-12,220,140,75,260,105,210,55,290,145,165,90
2008-11,190,135,95,230,115,195,60,275,120,155,100
2008-10,175,120,85,210,130,185,45,265,100,150,125
2008-09,160,115,100,220,95,170,50,250,110,140,135
2008-08,210,160,70,240,140,155,60,230,80,130,145
2008-07,180,150,65,225,125,165,55,215,90,120,160
2008-06,195,135,90,215,110,140,75,200,85,110,170
2008-05,170,125,80,205,100,130,50,190,95,145,120
2008-04,155,145,65,190,115,120,55,175,70,160,110
2008-03,200,140,75,180,130,110,60,165,85,170,100
2008-02,140,120,55,170,85,105,65,160,95,155,150
2008-01,130,115,70,160,100,95,50,145,80,140,135
2007-12,240,165,95,290,130,215,45,320,140,170,100
2007-11,220,155,105,275,150,200,60,310,125,160,110
2007-10,210,145,115,255,135,195,50,280,115,150,120
2007-09,195,135,90,240,145,180,55,270,100,140,130
2007-08,175,155,85,230,125,170,40,255,95,160,105
2007-07,165,140,70,210,110,160,60,250,105,130,115
2007-06,190,135,95,200,120,150,65,230,85,120,125
2007-05,170,120,60,190,130,140,50,215,80,110,150
2007-04,155,125,85,180,100,130,45,200,75,115,140
2007-03,185,115,75,170,110,120,55,190,90,105,130
2007-02,145,100,70,160,85,110,40,180,65,125,120
2007-01,135,110,65,150,90,100,50,170,75,140,110
2006-12,250,175,100,290,140,220,60,315,125,200,90
2006-11,230,160,90,275,130,205,50,300,115,180,100
2006-10,215,145,105,260,120,195,65,290,110,155,135
2006-09,205,130,85,240,95,180,55,270,100,170,125
2006-08,190,150,75,220,110,170,45,255,90,165,130
2006-07,175,140,100,210,105,165,60,240,85,150,120
2006-06,200,125,70,200,115,150,50,230,95,140,145
2006-05,180,130,65,190,100,140,55,210,105,120,135
2006-04,160,115,85,175,90,130,60,195,80,110,125
2006-03,170,105,75,160,95,120,50,180,70,125,140
2006-02,150,100,60,150,85,110,55,170,65,115,130
2006-01,140,90,80,140,70,100,40,160,75,105,120
2005-12,260,185,120,300,170,240,70,320,140,210,105
2005-11,240,170,110,285,150,225,60,310,130,195,95
2005-10,230,160,100,275,135,215,55,295,120,180,135
2005-09,210,145,115,255,125,200,50,280,105,160,125
2005-08,195,155,90,240,140,185,45,270,95,175,115
2005-07,175,165,80,230,130,170,60,260,100,155,145
2005-06,190,150,65,220,120,160,55,245,85,140,135
2005-05,180,135,105,210,110,145,50,230,90,130,125
2005-04,160,125,95,200,100,130,65,215,75,120,115
2005-03,170,115,85,190,90,120,45,205,80,110,105
2005-02,150,105,70,175,75,110,50,195,65,100,140
2005-01,140,95,60,165,80,100,40,185,55,90,130
2004-12,195,135,85,245,115,170,60,300,90,200,140
2004-11,210,125,75,230,135,185,50,285,100,180,150
2004-10,180,140,65,220,120,190,55,275,105,165,130
2004-09,200,130,95,205,110,175,45,260,85,160,145
2004-08,190,120,70,250,100,160,50,240,90,180,135
2004-07,170,115,80,235,140,155,60,225,95,150,125
2004-06,185,105,60,220,130,145,65,210,75,170,120
2004-05,165,95,55,205,125,140,50,195,85,160,115
2004-04,175,100,85,195,115,130,40,180,100,150,110
2004-03,160,90,65,180,105,120,45,165,70,140,100
2004-02,145,85,75,165,90,110,35,150,55,130,125
2004-01,130,80,60,150,85,100,50,140,65,120,135
2003-12,220,155,85,275,175,200,50,320,100,230,150
2003-11,200,145,90,255,160,185,60,305,110,215,130
2003-10,190,135,105,240,140,170,65,290,120,195,140
2003-09,210,125,80,230,130,160,55,275,90,180,135
2003-08,180,115,65,220,120,150,40,260,70,165,125
2003-07,200,140,95,210,110,130,45,245,105,155,145
2003-06,170,130,85,200,100,125,50,235,90,140,135
2003-05,185,120,75,195,90,115,60,220,80,135,125
2003-04,160,110,55,180,85,100,65,210,75,125,115
2003-03,175,100,70,170,95,105,35,190,60,115,105
2003-02,150,90,65,160,80,95,45,180,55,105,145
2003-01,140,85,50,150,75,85,40,175,65,110,135
2002-12,215,150,100,260,135,210,60,300,120,195,170
2002-11,195,140,95,250,125,195,50,290,110,180,160
2002-10,180,130,70,230,140,185,55,270,105,170,145
2002-09,200,120,85,220,115,170,45,260,90,175,135
2002-08,170,110,75,210,125,165,40,250,95,160,125
2002-07,185,125,65,200,135,150,60,235,85,145,130
2002-06,160,105,55,190,120,140,50,225,80,135,115
2002-05,180,115,70,180,110,130,40,210,65,120,140
2002-04,165,95,80,170,100,120,45,200,75,115,125
2002-03,150,90,60,160,85,110,55,190,50,105,110
2002-02,140,85,50,150,75,100,35,175,65,130,115
2002-01,130,70,95,140,65,90,40,160,80,120,105
2001-12,230,145,85,280,135,200,55,320,90,210,155
2001-11,210,135,100,265,150,185,65,305,85,195,140
2001-10,190,125,75,250,140,170,50,290,95,180,130
2001-09,175,115,85,230,125,165,60,275,105,160,125
2001-08,185,105,90,215,110,155,40,260,80,145,140
2001-07,170,100,55,200,95,140,45,240,70,135,130
2001-06,160,90,70,190,120,130,50,225,85,125,120
2001-05,180,110,65,180,110,125,30,210,55,115,115
2001-04,150,95,75,165,105,115,45,200,65,105,110
2001-03,170,85,60,155,90,100,50,190,70,135,100
2001-02,140,80,55,145,85,90,40,175,50,125,95
2001-01,130,75,65,135,70,85,35,160,60,115,120
2000-12,240,160,95,300,150,215,65,340,105,225,180
2000-11,220,150,85,280,135,205,50,320,90,210,165
2000-10,205,140,75,260,125,190,55,300,100,195,145
2000-09,185,130,70,240,115,175,45,280,80,180,140
2000-08,175,120,95,230,140,165,50,260,85,170,135
2000-07,195,135,80,210,110,150,65,250,75,160,130
2000-06,170,125,60,200,100,140,40,230,70,165,120
2000-05,180,115,75,190,130,130,55,215,65,150,110
2000-04,160,105,65,180,90,120,35,200,85,145,145
2000-03,150,95,85,170,120,110,60,180,55,135,125
2000-02,140,85,50,160,100,100,40,190,65,130,115
2000-01,130,75,70,150,80,90,45,175,60,120,105
1999-12,220,175,100,290,145,215,60,320,110,240,180
1999-11,210,160,80,275,130,200,50,305,95,230,170
1999-10,195,150,90,260,120,190,55,285,105,220,155
1999-09,180,140,85,240,110,180,45,270,100,210,145
1999-08,200,130,70,225,135,170,50,255,90,195,160
1999-07,175,120,75,215,125,155,40,240,85,180,135
1999-06,190,110,65,200,115,150,55,230,95,170,125
1999-05,165,100,90,190,105,160,60,210,80,150,140
1999-04,180,95,85,175,140,130,45,195,70,140,130
1999-03,160,85,75,170,120,135,40,180,65,130,115
1999-02,150,80,65,160,90,125,55,170,60,120,100
1999-01,140,70,60,150,80,115,50,160,55,110,105
1998-12,230,165,105,305,150,225,65,330,120,250,190
1998-11,215,150,95,290,135,210,50,315,105,240,175
1998-10,200,140,85,270,120,190,55,295,100,230,160
1998-09,185,130,70,250,110,175,60,280,90,220,145
1998-08,175,120,75,235,100,165,40,265,85,210,135
1998-07,195,115,65,220,130,150,50,245,95,200,150
1998-06,170,105,90,205,115,135,55,230,85,190,125
1998-05,185,100,80,195,140,125,60,215,75,180,140
1998-04,160,90,70,180,130,120,45,205,65,170,130
1998-03,150,85,65,170,120,110,50,195,60,160,115
1998-02,140,75,55,160,90,100,35,185,50,150,120
1998-01,130,65,60,150,80,95,45,170,55,140,110
1997-12,240,170,110,320,160,230,60,350,125,260,185
1997-11,225,160,90,305,145,215,50,330,115,250,170
1997-10,210,150,85,285,130,200,65,310,105,240,155
1997-09,195,140,75,270,115,180,55,290,90,230,140
1997-08,185,130,70,255,100,170,50,275,85,220,130
1997-07,200,125,65,240,140,160,45,260,95,210,145
1997-06,180,115,55,225,120,150,40,245,80,190,135
1997-05,170,105,80,215,135,140,60,225,75,180,125
1997-04,160,100,70,200,110,130,50,205,65,170,115
1997-03,150,90,60,185,120,120,55,195,60,160,105
1997-02,140,85,65,170,100,110,45,180,55,150,125
1997-01,130,75,55,160,90,100,40,165,50,140,110
1996-12,250,180,120,340,160,240,65,370,135,270,195
1996-11,230,165,110,320,150,225,50,350,125,260,170
1996-10,215,155,95,300,135,210,55,335,115,250,160
1996-09,200,140,85,280,120,190,60,315,105,235,140
1996-08,190,130,70,265,110,175,45,295,90,220,130
1996-07,175,120,80,250,100,160,50,275,85,210,150
1996-06,185,115,65,235,130,150,55,255,75,200,135
1996-05,160,105,75,220,110,140,60,240,65,190,125
1996-04,170,100,70,210,105,130,45,225,55,180,115
1996-03,150,90,60,195,95,120,50,205,70,165,105
1996-02,140,80,50,180,85,110,40,190,65,155,95
1996-01,130,75,65,170,90,100,55,185,55,145,120
1995-12,260,195,130,350,175,250,75,380,140,270,210
1995-11,240,180,100,330,160,230,60,360,120,260,190
1995-10,225,170,90,310,150,220,55,340,110,245,180
1995-09,210,155,75,290,130,200,50,320,100,230,165
1995-08,195,145,85,270,120,185,65,305,95,220,150
1995-07,180,135,60,250,115,170,55,280,85,210,130
1995-06,200,125,95,230,135,160,50,265,80,190,140
1995-05,165,115,75,215,105,150,45,250,90,180,125
1995-04,175,110,60,200,120,140,40,230,70,170,115
1995-03,155,95,85,185,100,130,50,210,65,160,105
1995-02,140,85,70,170,90,120,45,195,60,150,110
1995-01,130,75,55,160,80,110,35,180,50,140,100
1994-12,270,190,125,360,180,240,65,400,140,285,200
1994-11,250,175,115,340,165,220,50,380,130,270,180
1994-10,235,160,95,320,150,210,60,355,120,255,165
1994-09,220,145,85,300,135,200,55,330,105,245,150
1994-08,205,135,75,280,120,185,65,310,100,230,140
1994-07,190,125,65,260,110,170,50,290,90,215,125
1994-06,210,115,80,240,130,160,45,270,95,200,135
1994-05,180,105,60,220,120,150,55,250,85,190,120
1994-04,175,100,65,200,115,140,50,225,75,180,110
1994-03,160,90,70,190,100,130,45,205,65,170,105
1994-02,150,85,55,175,90,120,35,195,60,160,115
1994-01,140,80,65,160,85,110,40,185,50,150,100
1993-12,280,200,135,370,190,255,75,420,145,300,215
1993-11,260,185,110,350,175,240,65,390,125,280,195
1993-10,245,170,105,330,160,230,70,370,115,260,185
1993-09,230,160,90,310,145,220,55,350,100,250,175
1993-08,215,150,80,295,130,210,65,330,95,235,160
1993-07,200,140,75,280,120,195,50,315,85,225,150
1993-06,185,130,60,265,110,180,45,300,80,215,140
1993-05,170,120,85,250,105,170,55,290,95,205,130
1993-04,160,110,70,230,95,160,50,270,65,190,120
1993-03,150,100,65,220,85,155,40,250,75,180,115
1993-02,135,90,55,205,75,140,60,235,50,170,100
1993-01,125,85,50,190,70,130,45,220,65,160,90
1992-12,290,210,140,380,195,260,80,430,150,320,230
1992-11,275,195,130,360,180,245,75,410,140,300,210
1992-10,255,180,115,340,165,230,65,390,120,285,190
1992-09,240,165,100,320,150,215,70,370,105,270,175
1992-08,225,155,90,305,135,200,55,350,95,255,160
1992-07,210,140,85,290,125,180,60,330,80,240,145
1992-06,195,130,75,270,115,170,50,310,90,230,135
1992-05,180,120,65,255,100,160,45,290,85,220,125
1992-04,165,110,85,240,95,150,55,275,75,205,115
1992-03,150,100,70,225,85,140,40,260,65,195,110
1992-02,140,90,60,210,75,130,50,240,55,185,105
1992-01,130,80,55,195,70,120,45,230,60,175,100
1991-12,300,220,150,390,200,270,85,440,160,330,240
1991-11,285,210,135,375,185,255,80,420,145,310,225
1991-10,270,195,125,355,170,240,70,400,130,295,210
1991-09,255,180,110,340,155,225,60,380,120,280,190
1991-08,240,165,100,320,145,210,50,360,110,265,175
1991-07,225,150,90,300,130,195,55,345,95,250,165
1991-06,210,140,75,285,115,180,50,330,85,240,150
1991-05,195,130,70,270,105,165,45,315,90,225,140
1991-04,180,120,65,255,95,155,55,295,75,210,125
1991-03,165,110,55,240,85,145,40,280,65,195,115
1991-02,150,100,60,220,75,135,50,260,70,185,105
1991-01,140,90,50,205,65,125,45,240,60,170,100
1990-12,310,225,155,400,210,275,90,450,165,340,250
1990-11,295,210,145,385,195,260,80,430,150,320,235
1990-10,280,195,130,370,180,245,70,410,135,305,220
1990-09,265,180,115,350,165,230,60,390,120,290,205
1990-08,250,170,100,335,150,215,55,370,110,275,190
1990-07,235,155,85,320,135,200,50,355,95,260,175
1990-06,220,145,75,300,125,185,65,340,85,245,160
1990-05,205,135,80,285,115,170,55,325,90,230,150
1990-04,190,125,70,265,105,160,50,310,80,215,135
1990-03,175,115,65,250,95,150,45,295,75,200,120
1990-02,160,100,55,235,85,135,40,270,65,185,110
1990-01,150,90,60,220,75,125,50,255,70,170,100
1989-12,320,235,160,410,215,285,95,460,170,350,260
1989-11,300,220,145,395,200,270,85,440,155,330,245
1989-10,285,205,130,375,185,250,70,420,140,310,230
1989-09,270,190,115,360,170,235,60,400,125,295,215
1989-08,255,175,100,340,155,220,55,380,110,275,200
1989-07,240,160,90,320,140,210,65,365,105,260,185
1989-06,225,150,75,305,130,190,50,345,95,245,170
1989-05,210,135,85,285,120,175,55,330,80,230,160
1989-04,195,125,70,270,110,165,45,315,90,215,145
1989-03,180,115,60,250,100,155,50,295,85,200,130
1989-02,165,105,55,235,90,140,40,280,70,185,115
1989-01,150,95,65,220,80,130,35,260,60,170,120
1988-12,330,245,170,420,225,295,100,475,180,360,275
1988-11,315,230,160,400,210,280,90,455,165,340,255
1988-10,300,215,140,385,195,265,80,435,145,325,240
1988-09,285,200,125,365,180,250,65,420,130,305,225
1988-08,270,185,110,345,165,235,60,400,120,290,210
1988-07,255,170,100,330,150,220,70,385,115,270,195
1988-06,240,160,90,310,140,205,55,365,105,260,180
1988-05,225,145,80,295,125,190,50,350,95,245,165
1988-04,210,130,70,280,115,175,45,335,85,230,150
1988-03,195,120,65,260,105,160,55,320,80,215,135
1988-02,180,110,55,245,95,145,50,305,70,200,125
1988-01,165,100,65,230,85,130,45,290,60,185,115
1987-12,340,255,180,435,235,310,110,485,190,370,285
1987-11,320,240,160,415,220,290,95,465,175,350,270
1987-10,305,225,145,400,205,275,85,450,160,335,255
1987-09,290,210,130,385,190,260,80,430,150,320,240
1987-08,275,195,120,365,175,245,70,410,135,300,225
1987-07,260,180,110,350,160,230,55,395,125,280,210
1987-06,245,170,100,330,150,215,65,380,110,270,195
1987-05,230,155,95,315,135,200,50,360,105,255,180
1987-04,215,145,75,300,125,185,45,340,90,240,165
1987-03,200,130,85,280,115,170,55,325,80,225,150
1987-02,185,120,65,265,100,160,40,310,75,210,140
1987-01,170,110,70,250,90,145,50,295,65,195,130
1986-12,350,265,190,450,240,320,115,500,200,380,290
1986-11,335,250,180,430,225,305,100,480,185,365,275
1986-10,320,235,160,410,210,285,85,460,170,345,260
1986-09,305,220,140,390,200,270,75,440,150,330,245
1986-08,290,205,125,375,185,255,65,420,140,310,230
1986-07,275,190,110,355,170,240,50,400,130,290,215
1986-06,260,175,100,335,160,220,60,385,115,275,200
1986-05,245,160,85,320,145,210,55,370,105,260,185
1986-04,230,150,90,305,130,195,45,350,95,245,170
1986-03,215,135,70,285,120,180,40,335,85,230,155
1986-02,200,125,75,270,110,165,50,315,80,215,145
1986-01,185,115,60,255,100,150,45,300,70,200,130
1985-12,360,275,200,465,250,330,120,515,210,390,300
1985-11,345,260,185,445,235,315,105,495,195,375,285
1985-10,330,245,170,425,220,295,90,475,180,355,270
1985-09,315,230,160,405,205,280,80,460,165,335,250
1985-08,300,215,145,390,190,265,70,430,150,315,235
1985-07,285,200,130,370,175,250,60,415,135,300,220
1985-06,270,185,110,350,160,235,50,395,120,280,205
1985-05,255,170,100,335,150,220,65,375,110,265,190
1985-04,240,155,90,320,135,205,55,355,95,250,175
1985-03,225,145,75,300,125,190,50,340,85,235,160
1985-02,210,130,80,285,110,175,45,320,70,220,150
1985-01,195,120,65,270,100,160,35,305,60,205,135
1984-12,370,285,210,480,255,340,125,530,220,400,310
1984-11,355,270,195,460,240,325,110,510,205,385,295
1984-10,340,255,180,440,225,310,95,490,190,365,280
1984-09,325,240,165,420,210,295,85,470,175,345,265
1984-08,310,225,150,400,195,280,70,450,160,330,250
1984-07,295,210,135,385,180,265,60,430,140,315,230
1984-06,280,195,120,365,165,250,55,410,125,295,215
1984-05,265,180,105,350,150,235,50,390,115,275,200
1984-04,250,165,95,335,135,220,40,370,100,260,185
1984-03,235,150,80,320,120,205,65,355,90,245,170
1984-02,220,135,70,305,110,190,50,340,85,230,160
1984-01,205,120,60,290,100,175,45,325,75,215,140
1983-12,380,295,215,495,265,350,130,545,230,410,320
1983-11,365,280,200,475,250,335,120,525,215,395,305
1983-10,350,265,180,455,235,315,105,505,195,375,290
1983-09,335,250,165,435,220,300,95,480,185,355,275
1983-08,320,235,150,415,205,285,85,460,170,335,260
1983-07,305,220,135,395,190,270,75,435,160,320,245
1983-06,290,210,120,375,175,255,60,415,145,300,225
1983-05,275,195,110,355,160,240,55,400,135,285,210
1983-04,260,180,100,340,145,225,45,380,120,265,195
1983-03,245,165,90,320,130,210,65,365,105,250,180
1983-02,230,150,80,305,120,195,50,350,95,235,170
1983-01,215,135,70,290,110,180,45,330,85,220,160
1982-12,390,305,225,510,275,360,135,560,240,420,330
1982-11,375,290,210,490,260,345,120,540,225,405,315
1982-10,360,275,195,470,245,330,105,520,210,385,300
1982-09,345,260,180,450,230,315,90,500,195,370,285
1982-08,330,245,165,430,215,300,85,480,180,350,270
1982-07,315,230,150,410,200,285,70,460,165,335,255
1982-06,300,215,135,390,185,270,55,440,150,320,235
1982-05,285,200,120,370,170,250,60,420,135,305,220
1982-04,270,185,110,355,160,235,45,400,125,290,205
1982-03,255,170,100,335,145,220,50,385,115,275,190
1982-02,240,155,90,320,130,205,65,370,100,260,175
1982-01,225,140,75,305,115,190,55,355,85,245,160
1981-12,400,315,235,525,285,370,145,580,250,430,340
1981-11,385,300,220,505,270,355,130,560,235,415,325
1981-10,370,285,200,485,255,340,120,540,220,395,310
1981-09,355,270,185,465,240,325,110,520,205,380,295
1981-08,340,255,170,445,225,310,95,500,190,360,280
1981-07,325,240,155,425,210,295,85,480,175,340,265
1981-06,310,225,140,405,195,280,75,460,160,325,250
1981-05,295,210,130,385,180,265,65,440,145,310,235
1981-04,280,195,115,365,165,250,50,420,130,290,220
1981-03,265,180,105,345,150,235,55,400,120,275,205
1981-02,250,165,90,325,135,220,45,385,110,260,190
1981-01,235,150,75,310,120,205,60,360,100,245,180
1980-12,410,320,245,540,290,385,160,590,260,440,350
1980-11,395,305,230,520,275,370,145,570,245,420,335
1980-10,380,290,215,500,260,355,130,550,230,405,320
1980-09,365,275,200,480,245,340,115,530,215,385,305
1980-08,350,260,185,460,230,325,100,510,200,365,290
1980-07,335,245,170,440,215,310,85,490,185,350,275
1980-06,320,230,160,420,200,295,75,470,170,330,260
1980-05,305,215,145,400,185,280,65,450,155,315,245
1980-04,290,200,130,380,170,265,50,430,140,295,230
1980-03,275,185,115,360,155,250,55,410,125,280,215
1980-02,260,170,100,340,140,235,45,390,110,265,200
1980-01,245,155,90,320,125,220,50,370,105,250,185
1979-12,420,330,255,550,300,395,170,610,270,450,365
1979-11,405,315,240,530,285,380,155,590,255,430,350
1979-10,390,300,225,510,270,365,145,570,240,410,335
1979-09,375,285,210,490,255,350,130,550,225,390,320
1979-08,360,270,195,470,240,335,115,530,210,370,305
1979-07,345,255,180,450,225,320,100,510,195,355,290
1979-06,330,240,165,430,210,305,90,490,180,335,275
1979-05,315,225,150,410,195,290,75,470,165,320,260
1979-04,300,210,135,390,180,275,65,450,150,300,245
1979-03,285,195,120,370,165,260,50,430,135,285,230
1979-02,270,180,105,350,150,245,55,410,120,265,215
1979-01,255,165,90,330,135,230,45,390,105,250,200
1978-12,430,335,265,565,310,405,175,620,280,460,375
1978-11,415,320,250,545,295,390,160,600,265,440,360
1978-10,400,305,240,525,280,375,150,580,250,420,345
1978-09,385,290,220,505,265,360,135,560,235,400,330
1978-08,370,275,205,485,250,345,120,540,220,380,315
1978-07,355,260,190,465,235,330,105,520,205,365,300
1978-06,340,245,175,445,220,315,95,500,190,345,285
1978-05,325,230,160,425,205,300,80,480,175,330,270
1978-04,310,215,145,405,190,285,70,460,160,310,255
1978-03,295,200,130,385,175,270,55,440,150,295,240
1978-02,280,185,115,365,160,255,50,420,135,275,225
1978-01,265,170,100,345,145,240,60,400,120,260,210
1977-12,440,345,275,575,320,415,185,630,290,475,385
1977-11,425,330,260,555,305,400,170,610,275,455,370
1977-10,410,315,245,535,290,385,155,590,260,435,355
1977-09,395,300,230,515,275,370,140,570,245,415,340
1977-08,380,285,215,495,260,355,125,550,230,395,325
1977-07,365,270,200,475,245,340,110,530,215,380,310
1977-06,350,255,185,455,230,325,95,510,200,365,295
1977-05,335,240,170,435,215,310,80,490,185,345,280
1977-04,320,225,155,415,200,295,70,470,170,325,265
1977-03,305,210,140,395,185,280,60,450,155,310,250
1977-02,290,195,125,375,170,265,45,430,140,290,235
1977-01,275,180,115,355,155,250,50,410,130,275,220
1976-12,450,355,285,585,330,425,195,640,300,490,400
1976-11,435,340,270,565,315,410,180,620,285,470,385
1976-10,420,325,255,545,300,395,165,600,270,450,370
1976-09,405,310,240,525,285,380,150,580,255,430,355
1976-08,390,295,225,505,270,365,135,560,240,410,340
1976-07,375,280,210,485,255,350,120,540,225,395,325
1976-06,360,265,195,465,240,335,105,520,210,375,310
1976-05,345,250,180,445,225,320,90,500,195,360,295
1976-04,330,235,165,425,210,305,75,480,180,340,280
1976-03,315,220,150,405,195,290,60,460,165,325,265
1976-02,300,205,135,385,180,275,55,440,150,310,250
1976-01,285,190,120,365,165,260,50,420,135,290,235
1975-12,460,365,295,595,340,435,205,650,310,500,410
1975-11,445,350,280,575,325,420,190,630,295,480,395
1975-10,430,335,265,555,310,405,175,610,280,460,380
1975-09,415,320,250,535,295,390,160,590,265,445,365
1975-08,400,305,235,515,280,375,145,570,250,425,350
1975-07,385,290,220,495,265,360,130,550,235,410,335
1975-06,370,275,205,475,250,345,115,530,220,395,320
1975-05,355,260,190,455,235,330,100,510,205,375,305
1975-04,340,245,175,435,220,315,85,490,190,360,290
1975-03,325,230,160,415,205,300,70,470,175,345,275
1975-02,310,215,145,395,190,285,55,450,160,325,260
1975-01,295,200,130,375,175,270,60,430,150,310,245
1974-12,470,375,305,605,350,445,215,660,320,510,420
1974-11,455,360,290,585,335,430,200,640,305,490,405
1974-10,440,345,275,565,320,415,185,620,290,470,390
1974-09,425,330,260,545,305,400,170,600,275,450,375
1974-08,410,315,245,525,290,385,155,580,260,435,360
1974-07,395,300,230,505,275,370,140,560,245,415,345
1974-06,380,285,215,485,260,355,125,540,230,400,330
1974-05,365,270,200,465,245,340,110,520,215,380,315
1974-04,350,255,185,445,230,325,95,500,200,365,300
1974-03,335,240,170,425,215,310,80,480,185,350,285
1974-02,320,225,155,405,200,295,65,460,170,330,270
1974-01,305,210,140,385,185,280,50,440,160,310,255
1973-12,480,385,315,615,360,455,225,670,330,520,430
1973-11,465,370,300,595,345,440,210,650,315,500,415
1973-10,450,355,285,575,330,425,195,630,300,480,400
1973-09,435,340,270,555,315,410,180,610,285,460,385
1973-08,420,325,255,535,300,395,165,590,270,445,370
1973-07,405,310,240,515,285,380,150,570,255,425,355
1973-06,390,295,225,495,270,365,135,550,240,410,340
1973-05,375,280,210,475,255,350,120,530,225,395,325
1973-04,360,265,195,455,240,335,105,510,210,375,310
1973-03,345,250,180,435,225,320,90,490,195,360,295
1973-02,330,235,165,415,210,305,75,470,180,340,280
1973-01,315,220,150,395,195,290,60,450,165,320,265
1972-12,490,395,325,625,370,465,235,680,340,530,440
1972-11,475,380,310,605,355,450,220,660,325,510,425
1972-10,460,365,295,585,340,435,205,640,310,490,410
1972-09,445,350,280,565,325,420,190,620,295,470,395
1972-08,430,335,265,545,310,405,175,600,280,450,380
1972-07,415,320,250,525,295,390,160,580,265,435,365
1972-06,400,305,235,505,280,375,145,560,250,415,350
1972-05,385,290,220,485,265,360,130,540,235,400,335
1972-04,370,275,205,465,250,345,115,520,220,380,320
1972-03,355,260,190,445,235,330,100,500,205,365,305
1972-02,340,245,175,425,220,315,85,480,190,345,290
1972-01,325,230,160,405,205,300,70,460,175,325,275
1971-12,500,405,335,635,380,475,245,690,350,540,450
1971-11,485,390,320,615,365,460,230,670,335,525,435
1971-10,470,375,305,595,350,445,215,650,320,505,420
1971-09,455,360,290,575,335,430,200,630,305,485,405
1971-08,440,345,275,555,320,415,185,610,290,465,390
1971-07,425,330,260,535,305,400,170,590,275,450,375
1971-06,410,315,245,515,290,385,155,570,260,430,360
1971-05,395,300,230,495,275,370,140,550,245,415,345
1971-04,380,285,215,475,260,355,125,530,230,395,330
1971-03,365,270,200,455,245,340,110,510,215,380,315
1971-02,350,255,185,435,230,325,95,490,200,360,300
1971-01,335,240,170,415,215,310,80,470,185,345,285
1970-12,510,415,345,645,390,485,255,700,360,550,460
1970-11,495,400,330,625,375,470,240,680,345,530,445
1970-10,480,385,315,605,360,455,225,660,330,510,430
1970-09,465,370,300,585,345,440,210,640,315,490,415
1970-08,450,355,285,565,330,425,195,620,300,470,400
1970-07,435,340,270,545,315,410,180,600,285,455,385
1970-06,420,325,255,525,300,395,165,580,270,435,370
1970-05,405,310,240,505,285,380,150,560,255,420,355
1970-04,390,295,225,485,270,365,135,540,240,400,340
1970-03,375,280,210,465,255,350,120,520,225,385,325
1970-02,360,265,195,445,240,335,105,500,210,365,310
1970-01,345,250,180,425,225,320,90,480,195,350,295
1969-12,520,425,355,655,400,495,265,710,370,560,470
1969-11,505,410,340,635,385,480,250,690,355,540,455
1969-10,490,395,325,615,370,465,235,670,340,520,440
1969-09,475,380,310,595,355,450,220,650,325,500,425
1969-08,460,365,295,575,340,435,205,630,310,480,410
1969-07,445,350,280,555,325,420,190,610,295,465,395
1969-06,430,335,265,535,310,405,175,590,280,450,380
1969-05,415,320,250,515,295,390,160,570,265,430,365
1969-04,400,305,235,495,280,375,145,550,250,415,350
1969-03,385,290,220,475,265,360,130,530,235,400,335
1969-02,370,275,205,455,250,345,115,510,220,380,320
1969-01,355,260,190,435,235,330,100,490,205,365,305
1968-12,530,435,365,665,410,505,275,720,380,570,480
1968-11,515,420,350,645,395,490,260,700,365,550,465
1968-10,500,405,335,625,380,475,245,680,350,530,450
1968-09,485,390,320,605,365,460,230,660,335,510,435
1968-08,470,375,305,585,350,445,215,640,320,490,420
1968-07,455,360,290,565,335,430,200,620,305,475,405
1968-06,440,345,275,545,320,415,185,600,290,455,390
1968-05,425,330,260,525,305,400,170,580,275,440,375
1968-04,410,315,245,505,290,385,155,560,260,420,360
1968-03,395,300,230,485,275,370,140,540,245,405,345
1968-02,380,285,215,465,260,355,125,520,230,385,330
1968-01,365,270,200,445,245,340,110,500,215,370,315
1967-12,540,445,375,675,420,515,285,730,390,580,490
1967-11,525,430,360,655,405,500,270,710,375,560,475
1967-10,510,415,345,635,390,485,255,690,360,540,460
1967-09,495,400,330,615,375,470,240,670,345,520,445
1967-08,480,385,315,595,360,455,225,650,330,500,430
1967-07,465,370,300,575,345,440,210,630,315,480,415
1967-06,450,355,285,555,330,425,195,610,300,465,400
1967-05,435,340,270,535,315,410,180,590,285,450,385
1967-04,420,325,255,515,300,395,165,570,270,430,370
1967-03,405,310,240,495,285,380,150,550,255,410,355
1967-02,390,295,225,475,270,365,135,530,240,395,340
1967-01,375,280,210,455,255,350,120,510,225,380,325
1966-12,550,455,385,685,430,525,295,740,400,590,500
1966-11,535,440,370,665,415,510,280,720,385,570,485
1966-10,520,425,355,645,400,495,265,700,370,550,470
1966-09,505,410,340,625,385,480,250,680,355,530,455
1966-08,490,395,325,605,370,465,235,660,340,510,440
1966-07,475,380,310,585,355,450,220,640,325,490,425
1966-06,460,365,295,565,340,435,205,620,310,475,410
1966-05,445,350,280,545,325,420,190,600,295,455,395
1966-04,430,335,265,525,310,405,175,580,280,440,380
1966-03,415,320,250,505,295,390,160,560,265,420,365
1966-02,400,305,235,485,280,375,145,540,250,405,350
1966-01,385,290,220,465,265,360,130,520,235,390,335
1965-12,560,465,395,695,440,535,305,750,410,600,510
1965-11,545,450,380,675,425,520,290,730,395,580,495
1965-10,530,435,365,655,410,505,275,710,380,560,480
1965-09,515,420,350,635,395,490,260,690,365,540,465
1965-08,500,405,335,615,380,475,245,670,350,520,450
1965-07,485,390,320,595,365,460,230,650,335,500,435
1965-06,470,375,305,575,350,445,215,630,320,480,420
1965-05,455,360,290,555,335,430,200,610,305,460,405
1965-04,440,345,275,535,320,415,185,590,290,445,390
1965-03,425,330,260,515,305,400,170,570,275,425,375
1965-02,410,315,245,495,290,385,155,550,260,410,360
1965-01,395,300,230,475,275,370,140,530,245,395,345
1964-12,570,475,405,705,450,545,315,760,420,610,520
1964-11,555,460,390,685,435,530,300,740,405,590,505
1964-10,540,445,375,665,420,515,285,720,390,570,490
1964-09,525,430,360,645,405,500,270,700,375,550,475
1964-08,510,415,345,625,390,485,255,680,360,530,460
1964-07,495,400,330,605,375,470,240,660,345,510,445
1964-06,480,385,315,585,360,455,225,640,330,490,430
1964-05,465,370,300,565,345,440,210,620,315,470,415
1964-04,450,355,285,545,330,425,195,600,300,455,400
1964-03,435,340,270,525,315,410,180,580,285,435,385
1964-02,420,325,255,505,300,395,165,560,270,420,370
1964-01,405,310,240,485,285,380,150,540,255,400,355
1963-12,580,485,415,715,460,555,325,770,430,620,530
1963-11,565,470,400,695,445,540,310,750,415,600,515
1963-10,550,455,385,675,430,525,295,730,400,580,500
1963-09,535,440,370,655,415,510,280,710,385,560,485
1963-08,520,425,355,635,400,495,265,690,370,540,470
1963-07,505,410,340,615,385,480,250,670,355,520,455
1963-06,490,395,325,595,370,465,235,650,340,500,440
1963-05,475,380,310,575,355,450,220,630,325,480,425
1963-04,460,365,295,555,340,435,205,610,310,460,410
1963-03,445,350,280,535,325,420,190,590,295,445,395
1963-02,430,335,265,515,310,405,175,570,280,425,380
1963-01,415,320,250,495,295,390,160,550,265,410,365
1962-12,590,495,425,725,470,565,335,780,440,630,540
1962-11,575,480,410,705,455,550,320,760,425,610,525
1962-10,560,465,395,685,440,535,305,740,410,590,510
1962-09,545,450,380,665,425,520,290,720,395,570,495
1962-08,530,435,365,645,410,505,275,700,380,550,480
1962-07,515,420,350,625,395,490,260,680,365,530,465
1962-06,500,405,335,605,380,475,245,660,350,510,450
1962-05,485,390,320,585,365,460,230,640,335,490,435
1962-04,470,375,305,565,350,445,215,620,320,470,420
1962-03,455,360,290,545,335,430,200,600,305,455,405
1962-02,440,345,275,525,320,415,185,580,290,435,390
1962-01,425,330,260,505,305,400,170,560,275,420,375
1961-12,600,505,435,735,480,575,345,790,450,640,550
1961-11,585,490,420,715,465,560,330,770,435,620,535
1961-10,570,475,405,695,450,545,315,750,420,600,520
1961-09,555,460,390,675,435,530,300,730,405,580,505
1961-08,540,445,375,655,420,515,285,710,390,560,490
1961-07,525,430,360,635,405,500,270,690,375,540,475
1961-06,510,415,345,615,390,485,255,670,360,520,460
1961-05,495,400,330,595,375,470,240,650,345,500,445
1961-04,480,385,315,575,360,455,225,630,330,480,430
1961-03,465,370,300,555,345,440,210,610,315,465,415
1961-02,450,355,285,535,330,425,195,590,300,445,400
1961-01,435,340,270,515,315,410,180,570,285,430,385
1960-12,610,515,445,745,490,585,355,800,460,650,560
1960-11,595,500,430,725,475,570,340,780,445,630,545
1960-10,580,485,415,705,460,555,325,760,430,610,530
1960-09,565,470,400,685,445,540,310,740,415,590,515
1960-08,550,455,385,665,430,525,295,720,400,570,500
1960-07,535,440,370,645,415,510,280,700,385,550,485
1960-06,520,425,355,625,400,495,265,680,370,530,470
1960-05,505,410,340,605,385,480,250,660,355,510,455
1960-04,490,395,325,585,370,465,235,640,340,490,440
1960-03,475,380,310,565,355,450,220,620,325,470,425
1960-02,460,365,295,545,340,435,205,600,310,450,410
1960-01,445,350,280,525,325,420,190,580,295,430,395
